########## .######  ######*@  ####  $ ####  ####################
##########    #### #@ #### $* #### .* ####    ##################
#################      ## .**$@##      ######  #################
##########     ### .$. ### $@$ ##  .$. ##      #################
#########     ### .$. ### $.$ ### .$. ### $.$ ###  @  ##########
##########.  #####@$$ #####   ######  #######.##################
#################     ### # # ###. $*@###   ####################
########## @ #####...#####$$$#####    ####    ##################
#########   .. ##  @$$ ###### ######  ######  ######  ##########
#################  ###### . . ### $$#@####    ##################
#########  *  ###     #### # #####$@.#####   ###################
###########   #####$$@###   #####     ### . . ##################
##########  ###### $$ ####... ###  @$ ###   ####################
########### @ #####   ######$ #### ...#### $$ ######  ##########
#########   .#### ## ####  $$@### #   ###.  ####################
#########   ##### @ ##### $$######. . ####    ##################
##########  ###### $$ ####... #### @$ ####   ###################
###########  #####@$.#### $$  ### . . #####   ##################
##########  #####     ###.**$@###   ######  ####################
#########. #  ###  $  ###. $#@###  $  ###. #  ##################
##################   #####   #### $$$ ### .+. ##################
#################     ###@$$$ ###  #...###    ##################
############  ######@ ######$.###   $.### # $.###    ###########
##########################@$.###################################
##########... ####  $ #### #$#####  $ ####  @ ##################
##########    ###  ## ### # $ ###  * .#### #@#####   ###########
#########  @ ####  # #### .#  ### .$$$ ## .#   #####   #########
#########  ######    ####  $*@ #### .# ####    #################
############ @####  $ ####  *.####  *.####  $ ######  ##########
##########. .#### * * ###  #  ### $ $ #### @ ###################
#################   #####  $  ####* . ####   @##################
#########  ######.*$  ### .$# #### @  ####   ###################
#########   ##### #  ####@$*.#####  . #### $# #####   ##########
#########   ##### .   ####*#$  ## .# $ ## @## ###     ##########
#########@     ## .$$. ## $..$ ## $..$ ## .$$. ##      #########
######### @#  ###.$   ###. # $###.$#   ##. # $ ##  #   #########
########### . ##### $  ## . $#@## #$ . ##  $ ##### . ###########
#########      ## $*** ## *  * ## *  * ## ***. ##     @#########
##########  ######  ######  ######.$$@####  . ####  ############
###########   #####.# ####  @ ####  $ #### #*#####   ###########
############  ###  #  ### . . ### @$$ ### # #####   ############
#########    #### $$ ###### @  ####  . ##### .##################
###########   ###  $# ###  .$ #### ##.####   @##################
#########   @  ##   *  ####.$###### * #####   ##################
##########    #### #$@#### .*.#### #$ ####    ##################
#################   #####   #####$$$@ ###...  ##################
##################.#  ####@$$ ####..$ #####   ##################
#########   #####     ###     #####.##### $*$ ###  +  ##########
##########  ##### .$  ###@.$  ### .$ #####  ####################
#########  ######  #  ###.$**@####    ####   ###################
#############  #### $$ #### #  ### .#$@##      ## ..############
###########   #####$#@##### $ ####   #####.*. ####    ##########
##########   #####$#@ #### $  ####  ##### $.  ###. .  ##########
#########     ### $$$.#### #@.#### # .####  # #####   ##########
##########  ######$   #### .# ####*.  ### $ ##### @ ############
##########   #### .$. ### $#$ ### .$. ###    ##### @############
#########      ## ###$ ## #  $ ## #.*$@## #.#  ##  .#  #########
#########    #### ##$#### # $  ## @.*. ###     ###  ############
#########   ##### # .  ## #$.  ## @$*# #####   #################
#########  $.  ##  $.  ####  ####  $.  ##@ $.  #################
##########    ####. ..#####$ @ ## $  $ ##   ####################
############   #### .# ##  $*$@##   .# #### #  ####   ##########
############   ###     ## **$ ###  * .##### #@#####   ##########
######### . . ###.$$$.### $@$ ###.$$$.### . . ##################
#########  #   ##  #.. ## $$$$$##  #...##  #   ##  @   #########
#########   #  ## $.$. ###.  $ ## $  .### .$.$ ##  #  @#########
##########. . ####  *.#####$ @ ## $  $ ##   ####################
##########  ######    ###  * . ## *$*$ ### .$. ###@  ###########
############  ####     ###*  # ## *$*. ##  @  ##################
#########  ######  ######  ######.$$ $@##  . . ##  #############
###################  #### $.@####  *  ###  *  ##################
#########     ### .$  ####.$#####  @  ### .$# ###     ##########
#########  #  ### *#$.### * $. ## @    ##   ####################
#########  ######...  ###.##  ###  $ $ ####$ $ ####@   #########
##########  ###### *  #### *#@#### *  ###  .$####    ###########
#########    @ ## $  $ ### ## ### $# $###  .. #### .. ##########
######### @######     ### .#.  ###$$$$ ## . .####    ###########
#########   ##### .$. ### $*  ####  *$ ### .$. #####  @#########
############  #####   ###  .*$ ##  *.$@###   #####  ############
############  #####   ###  .*$ ##  *.$@###   ######  # #########
#########      ## #$.@ ##  $.#### #$.####   ####################
#########   #####  $.  ### $.  ####$.######@ ###################
###########  ######  ######$.####  $.#### #$. ###   @ ##########
#########   ##### #$.  ##  .$#@####$.  ####  ######  ###########
###########    ##  $.# ##@#.$  ## #$.####    ###################
############   ##  $.# ##@#.$  ## #$.#### #  ####    ###########
########### . ##### * ##### * ####  * #### @$ ####  ############
#########  @##### #$$  ##  $.# ####..  #####   #################
############ @###  $$ ### #$.  ##  ..# #####   #################
############  #####   ###  $  ### .*.##### $ ######@ ###########
############  ######$ #### .*.#### #$ ####  @ ####   ###########
#########   #####  $ #####$*. #### .@  ###  #  ######  #########
#########   ##### #@$  ##  $*. #####. ####    ####   ###########
###########   #####   ###  * #### .@$####  * #####  ############
##########  ###### * #### .@$ ###  *  ###  #  ##################
###########   #### *  ### .@$####  *  #####   ##################
###########  ######  ##### $*  ##  *. @##   #####  #############
###########@ ######  ######$* ###  *.  ##      ######  #########
############ ####@ ### ## $$ #### $ .  ### ..  #################
#########    ####    ##### $$##### $@.##### ..##################